##############
#............#
#............#
#.....##.....#
#.....##.....#
#...######...#
#...######...#
#.....##.....#
#.....##.....#
#............#
#......@.....#
##############
