#############
#...........#
#...........#
#..#..#..#..#
#..#..#..#..#
#..#..#..#..#
#..#..#..#..#
#..#..#..#..#
#..#..#..#..#
#..#..#..#..#
#..#..#..#..#
#...........#
#.....@.....#
#############
