##############
#............#
#............#
#..#..##..#..#
#..#..##..#..#
#..#..##..#..#
#..#..##..#..#
#..#..##..#..#
#..#..##..#..#
#............#
#......@.....#
##############
